A1,A1_0,A1_1,A1_2,A1_3,A1_4
0,1,0,0,0,0
1,0,1,0,0,0
2,0,0,1,0,0
3,0,0,0,1,0
4,0,0,0,0,1
